§#######
§#     #
§# .$. #
## $@$ #
#  .$. #
#      #
########