######
#    #
# #@ #
# $  #
# .  #
#    #
######