########
#      #
# .  $@#
#      #
#####  #
§§§§####